{
  "width": 10,
  "height": 10,
  "tileSize": 32,

  "tiles": [
    [1,1,1,1,1,1,1,1,1,1],
    [1,0,0,0,0,0,0,0,0,1],
    [1,0,0,0,0,0,0,0,0,1],
    [1,0,1,1,0,0,1,1,0,1],
    [1,0,1,1,0,0,1,1,0,1],
    [1,0,1,1,0,0,1,1,0,1],
    [1,0,0,0,0,0,0,0,0,1],
    [1,0,0,0,0,0,0,0,0,1],
    [1,0,0,0,0,0,0,0,0,1],
    [1,1,1,1,1,1,1,1,1,1]
  ]
}
